11111111111111
1ECCC000000001
1CC00CCCC00101
1C0001001CC101
100000CC000001
11CC0000011111
1P000000000001
11111111111111
