111111111111111
1E1000000000001
1CC001010010001
1C0001001010101
100000000000001
111111111000001
1P0000000000001
111111111111111
