1111111111111111111111111
100010001C001000100010C11
1C10001000100010001000011
1011111111111111111111111
100C00000000000000000C001
1111111111111111111111101
10C000000000C000000000001
1011111111111111111111111
1000000000000000000000PE1
1111111111111111111111111
