11111111111111111111111111111111111
11111CCCCCCC11111CCCCCCCCCCCCCCC111
11111CCCCCCC11111CCCPCCCCCCCCCCC111
11111CCCCCCCCCECCCCCCCCCCCCCCCCC111
11111CCCCCCC11111CCCCCCCCCCCCCCC111
11111CCCCCC11111CC1111111111CCCC111
11111CCCCCCC11111CCCCCCCCCCCCCCC111
11111111111111111111111111111111111
